geneSymbol	description
OAF1	Oleate-activated transcription factor; acts alone and as a heterodimer with Pip2p; activates genes involved in beta-oxidation of fatty acids and peroxisome organization and biogenesis; OAF1 has a paralog, PIP2, that arose from the whole genome duplication
FUN12	GTPase required for general translation initiation; promotes Met-tRNAiMet binding to ribosomes and ribosomal subunit joining; promotes GTP-dependent maturation of 18S rRNA by Nob1p; protein abundance increases in response to DNA replication stress; homolog of bacterial IF2
FUN30	Snf2p family member with ATP-dependent chromatin remodeling activity; has a role in silencing at the mating type locus, telomeres and centromeres; enriched at centromeres and is required for correct chromatin structure around centromeres, as well as at the boundary element of the silent HMR; recruited to DNA double-strand breaks (DSBs) where it promotes 5' strand resection of DSBs; potential Cdc28p substrate
PSK1	PAS domain-containing serine/threonine protein kinase; coordinately regulates protein synthesis and carbohydrate metabolism and storage in response to a unknown metabolite that reflects nutritional status; PSK1 has a paralog, PSK2, that arose from the whole genome duplication
VPS8	Membrane-binding component of the CORVET complex; involved in endosomal vesicle tethering and fusion in the endosome to vacuole protein targeting pathway; interacts with Vps21p; contains RING finger motif
SWH1	Protein similar to mammalian oxysterol-binding protein; contains ankyrin repeats; localizes to the Golgi and the nucleus-vacuole junction; SWH1 has a paralog, OSH2, that arose from the whole genome duplication
FLO1	Lectin-like protein involved in flocculation; cell wall protein that binds mannose chains on the surface of other cells, confers floc-forming ability that is chymotrypsin sensitive and heat resistant; FLO1 has a paralog, FLO5, that arose from a segmental duplication
VTH2	Putative membrane glycoprotein with strong similarity to Vth1p and Pep1p/Vps10p, may be involved in vacuolar protein sorting
UBP12	Ubiquitin-specific protease; cleaves ubiquitin from ubiquitinated proteins; present in the nucleus and cytoplasm
SAP185	Protein that forms a complex with the Sit4p protein phosphatase; required for Sit4p function; member of a family of similar proteins including Sap4p, Sap155p, and Sap190p; SAP185 has a paralog, SAP190, that arose from the whole genome duplication
BCK1	Mitogen-activated protein (MAP) kinase kinase kinase acting in the protein kinase C signaling pathway, which controls cell integrity; upon activation by Pkc1p phosphorylates downstream kinases Mkk1p and Mkk2p
SRS2	DNA helicase and DNA-dependent ATPase involved in DNA repair and checkpoint recovery, needed for proper timing of commitment to meiotic recombination and transition from Meiosis I to II; blocks trinucleotide repeat expansion; affects genome stability
NET1	Core subunit of the RENT complex; involved in nucleolar silencing and telophase exit; stimulates transcription by RNA polymerase I and regulates nucleolar structure; NET1 has a paralog, TOF2, that arose from the whole genome duplication
MTR4	ATP-dependent 3'-5' RNA helicase of the DExD/H family; involved in nuclear RNA processing and degradation both as a component of TRAMP complex and in TRAMP-independent processes; TRAMP unwinds RNA duplexes, with Mtr4p unwinding activity stimulated by Pap2p/Air2p but not dependent on ongoing polyadenylation; contains an arch domain, with two coiled-coil arms/stalks and a globular fist/KOW domain, which has RNA binding activity and is required for 5.8S rRNA processing
MHP1	Microtubule-associated protein involved in assembly and stabilization of microtubules; overproduction results in cell cycle arrest at G2 phase; similar to Drosophila protein MAP and to mammalian MAP4 proteins
CYR1	Adenylate cyclase, required for cAMP production and cAMP-dependent protein kinase signaling; the cAMP pathway controls a variety of cellular processes, including metabolism, cell cycle, stress response, stationary phase, and sporulation
RAD26	Protein involved in transcription-coupled nucleotide excision repair of UV-induced DNA lesions; recruitment to DNA lesions is dependent on an elongating RNA polymerase II; homolog of human CSB protein
	Putative protein of unknown function; the authentic, non-tagged protein is detected in highly purified mitochondria in high-throughput studies
TOR1	PIK-related protein kinase and rapamycin target; subunit of TORC1, a complex that controls growth in response to nutrients by regulating translation, transcription, ribosome biogenesis, nutrient transport and autophagy; involved in meiosis; TOR1 has a paralog, TOR2, that arose from the whole genome duplication
BUD4	Anillin-like protein involved in bud-site selection; required for the axial budding pattern; localizes with septins to the bud neck in mitosis and may constitute an axial landmark for the next round of budding; required for the formation and disassembly of the double septin ring structure, and generally for septin organization; in vivo substrate of Cdc28p/Clb2p
NMD5	Karyopherin, a carrier protein involved in nuclear import of proteins; importin beta homolog
IML1	Subunit of both the SEA (Seh1-associated) and Iml1p complexes; SEA complex is a coatomer-related complex that associates dynamically with the vacuole; Iml1p complex (Iml1p-Npr2p-Npr3p) is required for non-nitrogen-starvation (NNS)-induced autophagy; localized to either pre-autophagosomal structures (PAS) or non-PAS structures during NNS-induced autophagy; has an N-terminal CDC48-like domain (RANS) required for NNS-induced autophagy and a C-terminal DEP domain
UBA1	Ubiquitin activating enzyme (E1); involved in ubiquitin-mediated protein degradation and essential for viability; protein abundance increases in response to DNA replication stress
LOS1	Nuclear pore protein involved in nuclear export of pre-tRNA and in re-export of mature tRNAs after their retrograde import from the cytoplasm
FAS1	Beta subunit of fatty acid synthetase, which catalyzes the synthesis of long-chain saturated fatty acids; contains acetyltransacylase, dehydratase, enoyl reductase, malonyl transacylase, and palmitoyl transacylase activities
SNU114	GTPase component of U5 snRNP involved in mRNA splicing via spliceosome; binds directly to U5 snRNA; proposed to be involved in conformational changes of the spliceosome; similarity to ribosomal translocation factor EF-2
APE2	Aminopeptidase yscII; may have a role in obtaining leucine from dipeptide substrates; APE2 has a paralog, AAP1, that arose from the whole genome duplication
HSL1	Nim1p-related protein kinase that regulates the morphogenesis and septin checkpoints; associates with the assembled septin filament; required along with Hsl7p for bud neck recruitment, phosphorylation, and degradation of Swe1p
RGT1	Glucose-responsive transcription factor; regulates expression of several glucose transporter (HXT) genes in response to glucose; binds to promoters and acts both as a transcriptional activator and repressor; RGT1 has a paralog, EDS1, that arose from the whole genome duplication
TTI1	Subunit of the ASTRA complex, involved in chromatin remodeling; telomere length regulator involved in the stability or biogenesis of PIKKs such as TORC1; similar to S. pombe Tti1p; detected in highly purified mitochondria in high-throughput studies
SAP190	Protein that forms a complex with the Sit4p protein phosphatase; required for Sit4p function; member of a family of similar proteins including Sap4p, Sap155p, and Sap185p; SAP190 has a paralog, SAP185, that arose from the whole genome duplication
NUP133	Subunit of Nup84p subcomplex of nuclear pore complex (NPC); contributes to nucleocytoplasmic transport, NPC biogenesis; is involved in establishment of a normal nucleocytoplasmic concentration gradient of GTPase Gsp1p; also plays roles in several processes that may require localization of genes or chromosomes at nuclear periphery, including double-strand break repair, transcription and chromatin silencing; relocalizes to cytosol in response to hypoxia; homolog of human NUP133
PRP16	DEAH-box RNA helicase involved in second catalytic step of splicing; exhibits ATP-dependent RNA unwinding activity; mediates the release of Yju2p and Cwc25p in the second step; in the absence of ATP, stabilizes the binding of Cwc25p to the spliceosome in the first catalytic step
MLP1	Myosin-like protein associated with the nuclear envelope; connects the nuclear pore complex with the nuclear interior; involved with Tel1p in telomere length control; involved with Pml1p and Pml39p in nuclear retention of unspliced mRNAs; MLP1 has a paralog, MLP2, that arose from the whole genome duplication
ESL2	Protein of unknown function; interacts with Pex14p; may interact with ribosomes, based on co-purification experiments; green fluorescent protein (GFP)-fusion protein localizes to the nucleus and cytoplasm; predicted to contain a PINc domain; ESL2 has a paralog, YIL151C, that arose from the whole genome duplication
FLO10	Member of the FLO family of cell wall flocculation proteins; not expressed in most lab strains; overproduction induces flocculation that can be inhibited by mannose, sucrose, or glucose; overproduction also promotes haploid invasive growth and diploid filamentous growth
NFT1	Putative transporter of the multidrug resistance-associated protein (MRP) subfamily; adjacent ORFs YKR103W and YKR104W are merged in different strain backgrounds.
SPA2	Component of the polarisome; functions in actin cytoskeletal organization during polarized growth; acts as a scaffold for Mkk1p and Mpk1p cell wall integrity signaling components; potential Cdc28p substrate; SPA2 has a paralog, SPH1, that arose from the whole genome duplication
BPT1	ABC type transmembrane transporter of MRP/CFTR family, found in vacuolar membrane, involved in the transport of unconjugated bilirubin and in heavy metal detoxification via glutathione conjugates, along with Ycf1p
RAD5	DNA helicase; proposed to promote replication fork regression during postreplication repair by template switching; RING finger containing ubiquitin ligase; stimulates the synthesis of free and PCNA-bound polyubiquitin chains by Ubc13p-Mms2p; required for error-prone translesion synthesis; forms nuclear foci upon DNA replication stress
SMC4	Subunit of the condensin complex; reorganizes chromosomes during cell division; forms a complex with Smc2p that has ATP-hydrolyzing and DNA-binding activity; required for tRNA gene clustering at the nucleolus; potential Cdc28p substrate
KIN2	Serine/threonine protein kinase involved in regulation of exocytosis; localizes to the cytoplasmic face of the plasma membrane; KIN2 has a paralog, KIN1, that arose from the whole genome duplication
SKG3	Protein of unknown function; green fluorescent protein (GFP)-fusion protein localizes to the cell periphery, cytoplasm, bud, and bud neck; potential Cdc28p substrate; similar to Skg4p; relocalizes from bud neck to cytoplasm upon DNA replication stress; SKG3 has a paralog, CAF120, that arose from the whole genome duplication
YEF3	Gamma subunit of translational elongation factor eEF1B; stimulates the binding of aminoacyl-tRNA (AA-tRNA) to ribosomes by releasing eEF1A (Tef1p/Tef2p) from the ribosomal complex; contains two ABC cassettes; binds and hydrolyzes ATP; YEF3 has a paralog, HEF3, that arose from the whole genome duplication
HAP1	Zinc finger transcription factor involved in the complex regulation of gene expression in response to levels of heme and oxygen; the S288C sequence differs from other strain backgrounds due to a Ty1 insertion in the carboxy terminus
MMS22	Subunit of an E3 ubiquitin ligase complex involved in replication repair; stabilizes protein components of the replication fork, such as the fork-pausing complex and leading strand polymerase, preventing fork collapse and promoting efficient recovery during replication stress; required for accurate meiotic chromosome segregation
FKS1	Catalytic subunit of 1,3-beta-D-glucan synthase; functionally redundant with alternate catalytic subunit Gsc2p; binds to regulatory subunit Rho1p; involved in cell wall synthesis and maintenance; localizes to sites of cell wall remodeling; FKS1 has a paralog, GSC2, that arose from the whole genome duplication
ROM2	GDP/GTP exchange factor (GEF) for Rho1p and Rho2p; mutations are synthetically lethal with mutations in rom1, which also encodes a GEF; Rom2p localization to the bud surface is dependent on Ack1p; ROM2 has a paralog, ROM1, that arose from the whole genome duplication
SMC6	Component of the SMC5-SMC6 complex; this complex plays a key role in the removal of X-shaped DNA structures that arise between sister chromatids during DNA replication and repair; homologous to S. pombe rad18
VIP1	Inositol hexakisphosphate (IP6) and inositol heptakisphosphate (IP7) kinase; IP7 production is important for phosphate signaling; involved in cortical actin cytoskeleton function, and invasive pseudohyphal growth analogous to S. pombe asp1
	Putative helicase with limited sequence similarity to human Rb protein; the authentic, non-tagged protein is detected in highly purified mitochondria in high-throughput studies; YLR419W is not an essential gene
	Protein of unknown function with similarity to human DOCK proteins (guanine nucleotide exchange factors); interacts with Ino4p; green fluorescent protein (GFP)-fusion protein localizes to the cytoplasm, YLR422W is not an essential protein
TUS1	Guanine nucleotide exchange factor (GEF) that modulate Rho1p activity; involved in the cell integrity signaling pathway; interacts with Rgl1p; localization of Tus1p to the bed neck is regulated by Rgl1p; multicopy suppressor of tor2 mutation and ypk1 ypk2 double mutation; potential Cdc28p substrate
SEN1	Presumed helicase and subunit of the Nrd1 complex (Nrd1p-Nab3p-Sen1p); complex interacts with the exosome to mediate 3' end formation of some mRNAs, snRNAs, snoRNAs, and CUTs; has a separate role in coordinating DNA replication with transcription, by associating with moving replication forks and preventing errors that occur when forks encounter transcribed regions; homolog of Senataxin, which is implicated in Ataxia-Oculomotor Apraxia 2 and a dominant form of ALS
HMG2	HMG-CoA reductase; converts HMG-CoA to mevalonate, a rate-limiting step in sterol biosynthesis; one of two isozymes; overproduction induces assembly of peripheral ER membrane arrays and short nuclear-associated membrane stacks; forms foci at the nuclear periphery upon DNA replication stress; HMG2 has a paralog, HMG1, that arose from the whole genome duplication
FMP27	Putative protein of unknown function; the authentic, non-tagged protein is detected in highly purified mitochondria in high-throughput studies
YRF1-4	Helicase encoded by the Y' element of subtelomeric regions, highly expressed in the mutants lacking the telomerase component TLC1; potentially phosphorylated by Cdc28p
YRF1-5	Helicase encoded by the Y' element of subtelomeric regions, highly expressed in the mutants lacking the telomerase component TLC1; potentially phosphorylated by Cdc28p
NAB6	Putative RNA-binding protein that associates with mRNAs encoding cell wall proteins in high-throughput studies; deletion mutants display increased sensitivity to some cell wall disrupting agents; expression negatively regulated by cAMP
TSL1	Large subunit of trehalose 6-phosphate synthase/phosphatase complex; Tps1p-Tps2p complex converts uridine-5'-diphosphoglucose and glucose 6-phosphate to trehalose; mutant has aneuploidy tolerance; protein abundance increases in response to DNA replication stress; TSL1 has a paralog, TPS3, that arose from the whole genome duplication
TDA9	DNA-binding protein, putative transcription factor; green fluorescent protein (GFP)-fusion protein localizes to the nucleus; null mutant is sensitive to expression of the top1-T722A allele; not an essential gene; TDA9 has a paralog, RSF2, that arose from the whole genome duplication
SPT5	Component of the universally conserved Spt4/5 complex (DSIF complex); the complex has multiple roles in concert with RNA polymerases I and II, including regulation of transcription elongation, RNA processing, quality control, and transcription-coupled DNA repair
CLU1	eIF3 component of unknown function; deletion causes defects in mitochondrial organization but not in growth or translation initiation, can rescue cytokinesis and mitochondrial organization defects of the Dictyostelium cluA- mutant
MYO5	One of two type I myosins; contains proline-rich tail homology 2 (TH2) and SH3 domains; MYO5 deletion has little effect on growth, but myo3 myo5 double deletion causes severe defects in growth and actin cytoskeleton organization; MYO5 has a paralog, MYO3, that arose from the whole genome duplication
ECM16	Essential DEAH-box ATP-dependent RNA helicase specific to the U3 snoRNP, predominantly nucleolar in distribution, required for 18S rRNA synthesis
POM152	Glycoprotein subunit of the transmembrane ring of the nuclear pore complex (NPC); contributes to nucleocytoplasmic transport, NPC biogenesis and spindle pole body duplication; homologous to human NUP210
ECM5	Non-essential protein of unknown function; contains ATP/GTP-binding site motif A; null mutant exhibits cellular volume up to four times greater than wild-type, also large drooping buds with elongated necks; relative distribution to the nucleus increases upon DNA replication stress
GCV2	P subunit of the mitochondrial glycine decarboxylase complex, required for the catabolism of glycine to 5,10-methylene-THF; expression is regulated by levels of 5,10-methylene-THF in the cytoplasm
	Putative protein of unknown function; green fluorescent protein (GFP)-fusion protein localizes to the cytoplasm; YMR196W is not an essential gene
ESC1	Protein localized to the nuclear periphery, involved in telomeric silencing; interacts with PAD4-domain of Sir4p
PEP5	Histone E3 ligase, component of CORVET tethering complex; peripheral vacuolar membrane protein required for protein trafficking and vacuole biogenesis; interacts with Pep7p; involved in ubiquitylation and degradation of excess histones
UBP15	Ubiquitin-specific protease involved in protein deubiquitination; catalytic activity regulated by an N-terminal TRAF-like domain and and C-terminal sequences; physically interacts with anaphase-promoting complex/cyclosome (APC/C) activator, Cdh1p; forms a complex with AAA peroxins Pex1p and Pex6p
FKS3	Protein involved in spore wall assembly, has similarity to 1,3-beta-D-glucan synthase catalytic subunits Fks1p and Gsc2p; the authentic, non-tagged protein is detected in highly purified mitochondria in high-throughput studies
	Putative protein of unknown function with some similarity to sialidase from Trypanosoma; YMR317W is not an essential gene
EGT2	Glycosylphosphatidylinositol (GPI)-anchored cell wall endoglucanase required for proper cell separation after cytokinesis, expression is activated by Swi5p and tightly regulated in a cell cycle-dependent manner
CAF120	Part of the CCR4-NOT transcriptional regulatory complex; involved in controlling mRNA initiation, elongation, and degradation; CAF120 has a paralog, SKG3, that arose from the whole genome duplication
TOF1	Subunit of a replication-pausing checkpoint complex; Tof1p-Mrc1p-Csm3p acts at the stalled replication fork to promote sister chromatid cohesion after DNA damage, facilitating gap repair of damaged DNA; interacts with the MCM helicase; relocalizes to the cytosol in response to hypoxia
PIK1	Phosphatidylinositol 4-kinase; catalyzes first step in the biosynthesis of phosphatidylinositol-4,5-biphosphate; may control cytokinesis through the actin cytoskeleton
POL2	Catalytic subunit of DNA polymerase (II) epsilon, a chromosomal DNA replication polymerase that exhibits processivity and proofreading exonuclease activity; also involved in DNA synthesis during DNA repair; interacts extensively with Mrc1p
RAD50	Subunit of MRX complex with Mre11p and Xrs2p; complex is involved in processing double-strand DNA breaks in vegetative cells, initiation of meiotic DSBs, telomere maintenance, and nonhomologous end joining; forms nuclear foci upon DNA replication stress
ATG2	Peripheral membrane protein required for autophagic vesicle formation; also required for vesicle formation during pexophagy and the cytoplasm-to-vaucole targeting (Cvt) pathway; involved in Atg9p cycling between the phagophore assembly site and mitochondria; essential for cell cycle progression from G2/M to G1 under nitrogen starvation; forms cytoplasmic foci upon DNA replication stress
CHS1	Chitin synthase I, requires activation from zymogenic form in order to catalyze the transfer of N-acetylglucosamine (GlcNAc) to chitin; required for repairing the chitin septum during cytokinesis; transcription activated by mating factor
APC1	Largest subunit of the Anaphase-Promoting Complex/Cyclosome; APC/C is a ubiquitin-protein ligase required for degradation of anaphase inhibitors, including mitotic cyclins, during the metaphase/anaphase transition; component of the platform domain of the APC/C, based on structural analysis; localizes to nuclear foci that become diffuse upon DNA replication stress
KRE33	Essential protein, required for biogenesis of the small ribosomal subunit; heterozygous mutant shows haploinsufficiency in K1 killer toxin resistance
POL1	Catalytic subunit of the DNA polymerase I alpha-primase complex, required for the initiation of DNA replication during mitotic DNA synthesis and premeiotic DNA synthesis
NST1	Protein of unknown function, mediates sensitivity to salt stress; interacts physically with the splicing factor Msl1p and also displays genetic interaction with MSL1
TOP2	Topoisomerase II, relieves torsional strain in DNA by cleaving and re-sealing the phosphodiester backbone of both positively and negatively supercoiled DNA; cleaves complementary strands; localizes to axial cores in meiosis; required for replication slow zone (RSZ) breakage following Mec1p inactivation
TCB2	ER protein involved in ER-plasma membrane tethering; one of 6 proteins (Ist2p, Scs2p, Scs22p, Tcb1p, Tcb2p, Tcb3p) that connect ER to plasma membrane (PM) and regulate PM phosphatidylinositol-4-phosphate (PI4P) levels by controlling access of Sac1p phosphatase to its substrate PI4P in the PM; contains 3 calcium and lipid binding domains; mRNA is targeted to bud; TCB2 has a paralog, TCB1, that arose from the whole genome duplication
VAC7	Integral vacuolar membrane protein involved in vacuole inheritance and morphology; activates Fab1p kinase activity under basal conditions and also after hyperosmotic shock
HEF3	Translational elongation factor EF-3; member of the ABC superfamily; stimulates EF-1 alpha-dependent binding of aminoacyl-tRNA by the ribosome; normally expressed in zinc deficient cells; HEF3 has a paralog, YEF3, that arose from the whole genome duplication
PDR18	Putative transporter of the ATP-binding cassette (ABC) family, implicated in pleiotropic drug resistance; the authentic, non-tagged protein is detected in highly purified mitochondria in high-throughput studies
PKH2	Serine/threonine protein kinase; involved in sphingolipid-mediated signaling pathway that controls endocytosis; activates Ypk1p and Ykr2p, components of signaling cascade required for maintenance of cell wall integrity; redundant with Pkh1p; PKH2 has a paralog, PKH1, that arose from the whole genome duplication
IRA2	GTPase-activating protein; negatively regulates RAS by converting it from the GTP- to the GDP-bound inactive form, required for reducing cAMP levels under nutrient limiting conditions; similar to human neurofibromin; IRA2 has a paralog, IRA1, that arose from the whole genome duplication
AVO1	Component of a membrane-bound complex containing the Tor2p kinase and other proteins, which may have a role in regulation of cell growth
GAL11	Subunit of the RNA polymerase II mediator complex; associates with core polymerase subunits to form the RNA polymerase II holoenzyme; affects transcription by acting as target of activators and repressors; forms part of the tail domain of mediator
PSK2	PAS-domain containing serine/threonine protein kinase; regulates sugar flux and translation in response to an unknown metabolite by phosphorylating Ugp1p and Gsy2p (sugar flux) and Caf20p, Tif11p and Sro9p (translation); PSK2 has a paralog, PSK1, that arose from the whole genome duplication
SMC5	Component of the SMC5-SMC6 complex; this complex plays a key role in the removal of X-shaped DNA structures that arise between sister chromatids during DNA replication and repair; binds single-stranded DNA and has ATPase activity; S. pombe homolog forms a heterodimer with S. pombe Rad18p that is involved in DNA repair
SIN3	Component of the Sin3p-Rpd3p histone deacetylase complex, involved in transcriptional repression and activation of diverse processes, including mating-type switching and meiosis; involved in the maintenance of chromosomal integrity
AUS1	Plasma membrane sterol transporter of the ATP-binding cassette family; required, along with Pdr11p, for uptake of exogenous sterols and their incorporation into the plasma membrane; activity is stimulated by phosphatidylserine; sterol uptake is required for anaerobic growth because sterol biosynthesis requires oxygen; AUS1 has a paralog, PDR11, that arose from the whole genome duplication
INP53	Polyphosphatidylinositol phosphatase; dephosphorylates multiple phosphatidylinositol phosphates; involved in trans Golgi network-to-early endosome pathway; hyperosmotic stress causes translocation to actin patches; contains Sac1 and 5-ptase domains; INP53 has a paralog, INP52, that arose from the whole genome duplication
RGA1	GTPase-activating protein for polarity-establishment protein Cdc42p; implicated in control of septin organization, pheromone response, and haploid invasive growth; relocalizes from bud neck to cytoplasm upon DNA replication stress; RGA1 has a paralog, RGA2, that arose from the whole genome duplication
PDR5	Plasma membrane ATP-binding cassette (ABC) transporter; multidrug transporter actively regulated by Pdr1p; also involved in steroid transport, cation resistance, and cellular detoxification during exponential growth; PDR5 has a paralog, PDR15, that arose from the whole genome duplication
MSB1	Protein of unknown function; may be involved in positive regulation of 1,3-beta-glucan synthesis and the Pkc1p-MAPK pathway; multicopy suppressor of temperature-sensitive mutations in CDC24 and CDC42, and of mutations in BEM4; potential Cdc28p substrate; relocalizes from bud neck to cytoplasm upon DNA replication stress
ULS1	Protein involved in proteolytic control of sumoylated substrates; contains RING finger domain; interacts with SUMO (Smt3p); member of the SWI/SNF family of DNA-dependent ATPases; plays a role in antagonizing silencing during mating-type switching; relocalizes from nucleus to cytoplasm upon DNA replication stress
HER1	Protein of unknown function required for proliferation or remodeling of the ER that is caused by overexpression of Hmg2p; may interact with ribosomes, based on co-purification experiments; HER1 has a paralog, GIP3, that arose from the whole genome duplication
YPK9	Vacuolar protein with a possible role in sequestering heavy metals; has similarity to the type V P-type ATPase Spf1p; homolog of human ATP13A2 (PARK9), mutations in which are associated with Parkinson disease and Kufor-Rakeb syndrome
	Putative protein of unknown function; green fluorescent protein (GFP)-fusion protein localizes to the cytoplasm; expressed during copper starvation; YOR296W is not an essential gene
ISW2	ATP-dependent DNA translocase involved in chromatin remodeling; ATPase component that, with Itc1p, forms a complex required for repression of a-specific genes, INO1, and early meiotic genes during mitotic growth; the Isw2 complex exhibits basal levels of chromatin binding throughout the genome as well as target-specific chromatin interactions
MYO2	Type V myosin motor involved in actin-based transport of cargos; required for the polarized delivery of secretory vesicles, the vacuole, late Golgi elements, peroxisomes, and the mitotic spindle; MYO2 has a paralog, MYO4, that arose from the whole genome duplication
PDR10	ATP-binding cassette (ABC) transporter, multidrug transporter involved in the pleiotropic drug resistance network; regulated by Pdr1p and Pdr3p
KRE5	Protein required for beta-1,6 glucan biosynthesis; mutations result in aberrant morphology and severe growth defects
RPA190	RNA polymerase I largest subunit A190
CIN1	Tubulin folding factor D involved in beta-tubulin (Tub2p) folding; isolated as mutant with increased chromosome loss and sensitivity to benomyl
YRF1-8	One of several telomeric Y' element-encoded DNA helicases, known as Y'-Help1 (Y'-HELicase Protein 1)
FAS2	Alpha subunit of fatty acid synthetase, which catalyzes the synthesis of long-chain saturated fatty acids; contains the acyl-carrier protein domain and beta-ketoacyl reductase, beta-ketoacyl synthase and self-pantetheinylation activities
NEW1	ATP binding cassette protein that cosediments with polysomes and is required for biogenesis of the small ribosomal subunit; Asn/Gln-rich rich region supports [NU+] prion formation and susceptibility to [PSI+] prion induction
	Putative protein of unknown function; not an essential gene; YPL216W has a paralog, ITC1, that arose from the whole genome duplication
CDC60	Cytosolic leucyl tRNA synthetase, ligates leucine to the appropriate tRNA
KAP120	Karyopherin responsible for the nuclear import of ribosome maturation factor Rfp1p
SEC16	COPII vesicle coat protein required for ER transport vesicle budding; essential factor in endoplasmic reticulum exit site (ERES) formation, as well as in COPII-mediated ER-to-Golgi traffic; bound to periphery of ER membranes and may act to stabilize initial COPII complexes; interacts with Sec23p, Sec24p and Sec31p
GCR1	Transcriptional activator of genes involved in glycolysis; DNA-binding protein that interacts and functions with the transcriptional activator Gcr2p
RAD1	Single-stranded DNA endonuclease (with Rad10p), cleaves single-stranded DNA during nucleotide excision repair and double-strand break repair; subunit of Nucleotide Excision Repair Factor 1 (NEF1); homolog of human XPF protein
SWI1	Subunit of the SWI/SNF chromatin remodeling complex; regulates transcription by remodeling chromatin; required for transcription of many genes, including ADH1, ADH2, GAL1, HO, INO1 and SUC2; can form the prion [SWI+]; human homolog ARID1A is a candidate tumor suppressor gene in breast cancer
RRP12	Protein required for export of the ribosomal subunits; associates with the RNA components of the pre-ribosomes; has a role in nuclear import in association with Pse1p; contains HEAT-repeats
NCR1	Vacuolar membrane protein that transits through the biosynthetic vacuolar protein sorting pathway, involved in sphingolipid metabolism; glycoprotein and functional orthologue of human Niemann Pick C1 (NPC1) protein
ATH1	Acid trehalase required for utilization of extracellular trehalose
CSR2	Nuclear ubiquitin protein ligase binding protein; may regulate utilization of nonfermentable carbon sources and endocytosis of plasma membrane proteins; overproduction suppresses chs5 spa2 lethality at high temp; ubiquitinated by Rsp5p, deubiquitinated by Ubp2p; CSR2 has a paralog, ECM21, that arose from the whole genome duplication
SRO7	Effector of Rab GTPase Sec4p; forms a complex with Sec4p and t-SNARE Sec9p; involved in exocytosis and docking and fusion of post-Golgi vesicles with plasma membrane; homolog of Drosophila lgl tumor suppressor; SRO7 has a paralog, SRO77, that arose from the whole genome duplication
SEC8	Essential 121 kDa subunit of the exocyst complex; the exocyst mediates polarized targeting and tethering of post-Golgi secretory vesicles to active sites of exocytosis at the plasma membrane prior to SNARE-mediated fusion; involved in ER and Golgi inheritance in small buds; relocalizes away from bud neck upon DNA replication stress
	Protein that contains a Phox homology (PX) domain and binds phosphoinositides; the authentic, non-tagged protein is detected in highly purified mitochondria in high-throughput studies
RGC1	Pleckstrin homology domain containing protein; proposed to function as a glycerol channel activator; green fluorescent protein (GFP)-fusion protein localizes to the cytoplasm; RGC1 has a paralog, ASK10, that arose from the whole genome duplication
	Putative protein of unknown function
AXL1	Haploid specific endoprotease that performs one of two N-terminal cleavages during maturation of a-factor mating pheromone; required for axial budding pattern of haploid cells
MMS1	Subunit of an E3 ubiquitin ligase complex involved in replication repair; stabilizes protein components of the replication fork such as the fork-pausing complex and leading strand polymerase, preventing fork collapse and promoting efficient recovery during replication stress; regulates Ty1 transposition; involved with Rtt101p in nonfunctional rRNA decay
GDB1	Glycogen debranching enzyme; contains glucanotranferase and alpha-1,6-amyloglucosidase activities; required for glycogen degradation; phosphorylated in mitochondria; activity is inhibited by Igd1p; protein abundance increases in response to DNA replication stress
SKI3	Ski complex component and TPR protein, mediates 3'-5' RNA degradation by the cytoplasmic exosome; null mutants have superkiller phenotype of increased viral dsRNAs and are synthetic lethal with mutations in 5'-3' mRNA decay; mutations in the human ortholog, TTC37, causes Syndromic diarrhea/Trichohepatoenteric (SD/THE) syndrome
	Helicase-like protein encoded within the telomeric Y' element
AI2	Reverse transcriptase required for splicing of the COX1 pre-mRNA, encoded by a mobile group II intron within the mitochondrial COX1 gene
AI3	Endonuclease I-SceIII, encoded by a mobile group I intron within the mitochondrial COX1 gene
AI4	Endonuclease I-SceII, encoded by a mobile group I intron within the mitochondrial COX1 gene; intron is normally spliced by the BI4p maturase but AI4p can mutate to acquire the same maturase activity
AI5_ALPHA	Endonuclease I-SceIV, involved in intron mobility; encoded by a mobile group I intron within the mitochondrial COX1 gene
COX1	Subunit I of cytochrome c oxidase, which is the terminal member of the mitochondrial inner membrane electron transport chain; one of three mitochondrially-encoded subunits
BI3	Mitochondrial mRNA maturase, forms a complex with Mrs1p to mediate splicing of the bI3 intron of the COB gene; encoded by both exon and intron sequences of partially processed COB mRNA
BI4	Mitochondrial mRNA maturase, forms a complex with Nam2p to mediate splicing of the bI4 intron of the COB gene; encoded by both exon and intron sequences of partially processed COB mRNA
COB	Cytochrome b, mitochondrially encoded subunit of the ubiquinol-cytochrome c reductase complex which includes Cobp, Rip1p, Cyt1p, Cor1p, Qcr2p, Qcr6p, Qcr7p, Qcr8p, Qcr9p, and Qcr10p
NUP170	Subunit of the inner ring of the nuclear pore complex (NPC); contributes to NPC assembly and nucleocytoplasmic transport; both Nup170p and NUP157p are similar to human Nup155p; NUP170 has a paralog, NUP157, that arose from the whole genome duplication
KIP1	Kinesin-related motor protein required for mitotic spindle assembly, chromosome segregation, and 2 micron plasmid partitioning; functionally redundant with Cin8p for chromosomal but not plasmid functions
APL3	Alpha-adaptin, large subunit of the clathrin associated protein complex (AP-2); involved in vesicle mediated transport
UTP20	Component of the small-subunit (SSU) processome, which is involved in the biogenesis of the 18S rRNA
VPS15	Serine/threonine protein kinase involved in vacuolar protein sorting; functions as a membrane-associated complex with Vps34p; active form recruits Vps34p to the Golgi membrane; interacts with the GDP-bound form of Gpa1p; myristoylated; a fraction is localized, with Vps34p, to nuclear pores at nucleus-vacuole junctions and may facilitate transcription elongation for genes positioned at the nuclear periphery
MEC1	Genome integrity checkpoint protein and PI kinase superfamily member; Mec1p and Dun1p function in same pathway to regulate both dNTP pools and telomere length; signal transducer required for cell cycle arrest and transcriptional responses prompted by damaged or unreplicated DNA; regulates P-body formation induced by replication stress; monitors and participates in meiotic recombination; associates with shortened, dysfunctional telomeres
VHC1	Vacuolar membrane cation-chloride cotransporter (CCC); likely mediates K+ and Cl- cotransport into the vacuole; has a role in potassium homeostasis and salt tolerance; similar to mammalian electroneutral Na(+)-(K+)-C1- cotransporter family
PCA1	Cadmium transporting P-type ATPase; may also have a role in copper and iron homeostasis; stabilized by Cd binding, which prevents ubiquitination; S288C and other lab strains contain a G970R mutation which eliminates Cd transport function
KCC4	Protein kinase of the bud neck involved in the septin checkpoint; associates with septin proteins, negatively regulates Swe1p by phosphorylation, shows structural homology to bud neck kinases Gin4p and Hsl1p; KCC4 has a paralog, GIN4, that arose from the whole genome duplication
BUD3	Protein involved in bud-site selection and required for axial budding pattern; localizes with septins to bud neck in mitosis and may constitute an axial landmark for next round of budding
BPH1	Protein homologous to Chediak-Higashi syndrome and Beige proteins; both of which are implicated in disease syndromes in human and mouse, respectively, due to defective lysosomal trafficking; mutant phenotype and genetic interactions suggest a role in protein sorting
SNT1	Subunit of the Set3C deacetylase complex that interacts directly with the Set3C subunit, Sif2p; putative DNA-binding protein; mutant has increased aneuploidy tolerance; relocalizes to the cytosol in response to hypoxia
SRB8	Subunit of the RNA polymerase II mediator complex; associates with core polymerase subunits to form the RNA polymerase II holoenzyme; essential for transcriptional regulation; involved in glucose repression
FIG2	Cell wall adhesin, expressed specifically during mating; may be involved in maintenance of cell wall integrity during mating; FIG2 has a paralog, AGA1, that arose from the whole genome duplication
CDC39	Component of the CCR4-NOT complex, which has multiple roles in regulating mRNA levels including regulation of transcription and destabilizing mRNAs by deadenylation; basal transcription factor
LRG1	Putative GTPase-activating protein (GAP) involved in the Pkc1p-mediated signaling pathway that controls cell wall integrity; appears to specifically regulate 1,3-beta-glucan synthesis
SEC31	Component of the Sec13p-Sec31p complex of the COPII vesicle coat, required for vesicle formation in ER to Golgi transport; mutant has increased aneuploidy tolerance
VMA1	Subunit A of the eight-subunit V1 peripheral membrane domain of the vacuolar H+-ATPase; protein precursor undergoes self-catalyzed splicing to yield the extein Tfp1p and the intein Vde (PI-SceI), which is a site-specific endonuclease
TRM3	2'-O-ribose methyltransferase, catalyzes the ribose methylation of the guanosine nucleotide at position 18 of tRNAs
POL3	Catalytic subunit of DNA polymerase delta; required for chromosomal DNA replication during mitosis and meiosis, intragenic recombination, repair of double strand DNA breaks, and DNA replication during nucleotide excision repair (NER)
USO1	Essential protein involved in the vesicle-mediated ER to Golgi transport step of secretion; binds membranes and functions during vesicle docking to the Golgi; required for assembly of the ER-to-Golgi SNARE complex
SNQ2	Plasma membrane ATP-binding cassette (ABC) transporter, multidrug transporter involved in multidrug resistance and resistance to singlet oxygen species
MAK21	Constituent of 66S pre-ribosomal particles, required for large (60S) ribosomal subunit biogenesis; involved in nuclear export of pre-ribosomes; required for maintenance of dsRNA virus; homolog of human CAATT-binding protein
DNF2	Aminophospholipid translocase (flippase) that localizes primarily to the plasma membrane; contributes to endocytosis, protein transport and cell polarity; type 4 P-type ATPase; DNF2 has a paralog, DNF1, that arose from the whole genome duplication
KIN1	Serine/threonine protein kinase involved in regulation of exocytosis; localizes to the cytoplasmic face of the plasma membrane; KIN1 has a paralog, KIN2, that arose from the whole genome duplication
ARO1	Pentafunctional arom protein, catalyzes steps 2 through 6 in the biosynthesis of chorismate, which is a precursor to aromatic amino acids
MTC5	Subunit of the SEA (Seh1-associated) complex; SEA is a coatomer-related complex that associates dynamically with the vacuole; has N-terminal WD-40 repeats and a C-terminal RING motif; mtc5 is synthetically sick with cdc13-1; relative distribution to vacuolar membrane punctae decreases upon DNA replication stress
NUM1	Protein required for nuclear migration, component of the mitochondria-ER-cortex-ancor (MECA); required for the association of mitochondria with the cell cortex and for accurate distribution of mitochondrial network; interacts with Mdm36p to link the ER and motochondria at the cortex; localizes to the mother cell cortex and the bud tip; may mediate interactions of dynein and cytoplasmic microtubules with the cell cortex
SAC3	Nuclear pore-associated protein; required for biogenesis of the small ribosomal subunit; component of TREX-2 complex (Sac3p-Thp1p-Sus1p-Cdc31p) involved in transcription elongation and mRNA export from the nucleus; involved in post-transcriptional tethering of active genes to the nuclear periphery and to non-nascent mRNP; similar to the human germinal center-associated nuclear protein (GANP)
SCC2	Subunit of cohesin loading factor (Scc2p-Scc4p); a complex required for loading of cohesin complexes onto chromosomes; involved in establishing sister chromatid cohesion during DSB repair via histone H2AX; evolutionarily-conserved adherin; relocalizes to the cytosol in response to hypoxia
ADR1	Carbon source-responsive zinc-finger transcription factor, required for transcription of the glucose-repressed gene ADH2, of peroxisomal protein genes, and of genes required for ethanol, glycerol, and fatty acid utilization
SIR4	Silent information regulator that, together with SIR2 and SIR3, is involved in assembly of silent chromatin domains at telomeres and the silent mating-type loci; potentially phosphorylated by Cdc28p; some alleles of SIR4 prolong lifespan
CCC2	Cu(+2)-transporting P-type ATPase; required for export of copper from the cytosol into an extracytosolic compartment; has similarity to human proteins involved in Menkes and Wilsons diseases; protein abundance increases in response to DNA replication stress; affects TBSV model (+)RNA virus replication by regulating copper metabolism
HRQ1	3'-5' DNA helicase that has DNA strand annealing activity; helicase activity is stimulated by fork structure and 3'-tail length of substrates; belongs to the widely conserved RecQ family of proteins which are involved in maintaining genomic integrity; similar to the human RecQ4p implicated in Rothmund-Thomson syndrome (RTS)
CFT1	RNA-binding subunit of the mRNA cleavage and polyadenylation factor; involved in poly(A) site recognition and required for both pre-mRNA cleavage and polyadenylation, 51% sequence similarity with mammalian AAUAA-binding subunit of CPSF
YCG1	Subunit of the condensin complex; required for establishment and maintenance of chromosome condensation, chromosome segregation and chromatin binding of the condensin complex; required for clustering of tRNA genes at the nucleolus; required for replication slow zone (RSZ) breakage following Mec1p inactivation
SWR1	Swi2/Snf2-related ATPase that is the structural component of the SWR1 complex, which exchanges histone variant H2AZ (Htz1p) for chromatin-bound histone H2A; relocalizes to the cytosol in response to hypoxia
MSN5	Karyopherin; involved in nuclear import and export of proteins, including import of replication protein A and export of Far1p and transcription factors Swi6p, Msn2p, and Pho4p; required for re-export of mature tRNAs after their retrograde import from the cytoplasm
RGA2	GTPase-activating protein for polarity-establishment protein Cdc42p; implicated in control of septin organization, pheromone response, and haploid invasive growth; regulated by Pho85p and Cdc28p; RGA2 has a paralog, RGA1, that arose from the whole genome duplication
PDR15	Plasma membrane ATP binding cassette (ABC) transporter; multidrug transporter and general stress response factor implicated in cellular detoxification; regulated by Pdr1p, Pdr3p and Pdr8p; promoter contains a PDR responsive element; PDR15 has a paralog, PDR5, that arose from the whole genome duplication
HKR1	Mucin family member that functions as an osmosensor in the Sho1p-mediated HOG pathway with Msb2p; proposed to be a negative regulator of filamentous growth; mutant displays defects in beta-1,3 glucan synthesis and bud site selection
TOM1	E3 ubiquitin ligase of the hect-domain class; has a role in mRNA export from the nucleus and may regulate transcriptional coactivators; involved in degradation of excess histones; interacts with Dia2p and is required for Dia2p degradation; required to target Cdc6p for ubiquitin-mediated destruction during G1 phase
SPP41	Protein of unknown function; involved in negative regulation of expression of spliceosome components PRP4 and PRP3; relocalizes to the cytosol in response to hypoxia
YRF1-1	Helicase encoded by the Y' element of subtelomeric regions, highly expressed in the mutants lacking the telomerase component TLC1; potentially phosphorylated by Cdc28p
SPF1	P-type ATPase, ion transporter of the ER membrane; required to maintain normal lipid composition of intracellular compartments and proper targeting of mitochondrial outer membrane tail-anchored proteins; involved in ER function and Ca2+ homeostasis; required for regulating Hmg2p degradation; confers sensitivity to a killer toxin (SMKT) produced by Pichia farinosa KK1
GEA2	Guanine nucleotide exchange factor for ADP ribosylation factors (ARFs); involved in vesicular transport between the Golgi and ER, Golgi organization, and actin cytoskeleton organization; GEA2 has a paralog, GEA1, that arose from the whole genome duplication
PRP22	DEAH-box RNA-dependent ATPase/ATP-dependent RNA helicase, associates with lariat intermediates before the second catalytic step of splicing; mediates ATP-dependent mRNA release from the spliceosome and unwinds RNA duplexes
SAK1	Upstream serine/threonine kinase for the SNF1 complex; partially redundant with Elm1p and Tos3p; members of this family have functional orthology with LKB1, a mammalian kinase associated with Peutz-Jeghers cancer-susceptibility syndrome; SAK1 has a paralog, TOS3, that arose from the whole genome duplication
CHD1	Chromatin remodeler that regulates various aspects of transcription; acts in in conjunction with Isw1b to regulate chromatin structure and maintain chromatin integrity during transcription elongation by RNAP II by preventing trans-histone exchange over coding regions; contains a chromo domain, a helicase domain and a DNA-binding domain; component of both the SAGA and SLIK complexes
DNF1	Aminophospholipid translocase (flippase) that localizes primarily to the plasma membrane; contributes to endocytosis, protein transport and cell polarity; type 4 P-type ATPase; DNF1 has a paralog, DNF2, that arose from the whole genome duplication
ECM32	DNA dependent ATPase/DNA helicase belonging to the Dna2p- and Nam7p-like family of helicases that is involved in modulating translation termination; interacts with the translation termination factors, localized to polysomes
YRF1-2	Helicase encoded by the Y' element of subtelomeric regions, highly expressed in the mutants lacking the telomerase component TLC1; potentially phosphorylated by Cdc28p; induced by treatment with 8-methoxypsoralen and UVA irradiation
RPO41	Mitochondrial RNA polymerase; single subunit enzyme similar to those of T3 and T7 bacteriophages; requires a specificity subunit encoded by MTF1 for promoter recognition; Mtf1p interacts with and stabilizes the Rpo41p-promoter complex, enhancing DNA bending and melting to facilitate pre-initiation open complex formation
	Putative integral membrane protein that interacts with Rpp0p, which is a component of the ribosomal stalk
SMC1	Subunit of the multiprotein cohesin complex, essential protein involved in chromosome segregation and in double-strand DNA break repair; SMC chromosomal ATPase family member, binds DNA with a preference for DNA with secondary structure
BLM10	Proteasome activator; binds the core proteasome and stimulates proteasome-mediated protein degradation by inducing gate opening; required for resistance to bleomycin, may be involved in protecting against oxidative damage; similar to mammalian PA200
FAB1	1-phosphatidylinositol-3-phosphate 5-kinase; vacuolar membrane kinase that generates phosphatidylinositol (3,5)P2, which is involved in vacuolar sorting and homeostasis
MET10	Subunit alpha of assimilatory sulfite reductase, which converts sulfite into sulfide
SAP155	Protein required for function of the Sit4p protein phosphatase; forms a complex with Sit4p; member of a family of similar proteins including Sap4p, Sap185p, and Sap190p; protein abundance increases in response to DNA replication stress; SAP155 has a paralog, SAP4, that arose from the whole genome duplication
KAP114	Karyopherin, responsible for nuclear import of specific proteins; cargoes include Spt15p, Sua7p, histones H2A and H2B, and Nap1p; amino terminus shows similarity to those of other importins, particularly Cse1p; localization is primarily nuclear; function is regulated by sumoylation; protein abundance increases in response to DNA replication stress
SPT16	Subunit of the heterodimeric FACT complex (Spt16p-Pob3p), which associates with chromatin via interaction with Nhp6Ap and Nhp6Bp, and reorganizes nucleosomes to facilitate access to DNA by RNA and DNA polymerases; some mutations cause reduced nucleosome occupancy over highly transcribed regions of the yeast genome
MDS3	Putative component of the TOR regulatory pathway; negative regulator of early meiotic gene expression; required, with Pmd1p, for growth under alkaline conditions; has an N-terminal kelch-like domain; MDS3 has a paralog, PMD1, that arose from the whole genome duplication
GCN1	Positive regulator of the Gcn2p kinase activity, forms a complex with Gcn20p; proposed to stimulate Gcn2p activation by an uncharged tRNA
MPT5	mRNA-binding protein of the PUF family; binds to the 3' UTR of specific mRNAs, including those involved in mating type switching, cell wall integrity, chronological lifespan, chromatin modification, and spindle pole body architecture; recruits the CCR4-NOT deadenylase complex to mRNAs along with Dhh1p and Dcp1p to promote deadenylation, decapping, and decay; also interacts with the Caf20p translational initiation repressor, affecting its mRNA target specificity
AMS1	Vacuolar alpha mannosidase, involved in free oligosaccharide (fOS) degradation; delivered to the vacuole in a novel pathway separate from the secretory pathway
NUT1	Component of the RNA polymerase II mediator complex, which is required for transcriptional activation and also has a role in basal transcription
ITC1	Subunit of ATP-dependent Isw2p-Itc1p chromatin remodeling complex; required for repression of a-specific genes, repression of early meiotic genes during mitotic growth, and repression of INO1; similar to mammalian Acf1p, the regulatory subunit of the mammalian ATP-utilizing chromatin assembly and modifying factor (ACF) complex; ITC1 has a paralog, YPL216W, that arose from the whole genome duplication
NUP145	Essential protein with distinct roles in two nuclear pore subcomplexes; catalyzes its own proteolytic cleavage in vivo to generate a C-terminal fragment that is a structural component of the Nup84p subcomplex (with roles in NPC biogenesis and localization of genes to the nuclear periphery), and an N-terminal fragment that is one of several FG-nucleoporins within the NPC central core directly responsible for nucleocytoplasmic transport; homologous to human NUP98
PYC1	Pyruvate carboxylase isoform; cytoplasmic enzyme that converts pyruvate to oxaloacetate; differentially regulated than isoform Pyc2p; mutations in the human homolog are associated with lactic acidosis; PYC1 has a paralog, PYC2, that arose from the whole genome duplication
KAP122	Karyopherin beta, responsible for import of the Toa1p-Toa2p complex into the nucleus; binds to nucleoporins Nup1p and Nup2p; may play a role in regulation of pleiotropic drug resistance
PMC1	Vacuolar Ca2+ ATPase involved in depleting cytosol of Ca2+ ions; prevents growth inhibition by activation of calcineurin in the presence of elevated concentrations of calcium; similar to mammalian PMCA1a
MSB2	Mucin family member involved in signaling; functions in the Cdc42p- and MAP kinase-dependent filamentous growth signaling pathway; is processed into secreted and cell-associated forms by the aspartyl protease, Yps1p; also functions as an osmosensor in parallel to the Sho1p-mediated pathway; potential Cdc28p substrate
GSC2	Catalytic subunit of 1,3-beta-glucan synthase; involved in formation of the inner layer of the spore wall; activity positively regulated by Rho1p and negatively by Smk1p; GSC2 has a paralog, FKS1, that arose from the whole genome duplication
ROM1	GDP/GTP exchange protein (GEP) for Rho1p; mutations are synthetically lethal with mutations in rom2, which also encodes a GEP; ROM1 has a paralog, ROM2, that arose from the whole genome duplication
UTP22	Component of the small-subunit processome; required for nuclear export of tRNAs; may facilitate binding of Utp8p to aminoacylated tRNAs and their delivery to Los1p for export; conserved from yeast to mammals
VAS1	Mitochondrial and cytoplasmic valyl-tRNA synthetase
ASK10	Component of RNA polymerase II holoenzyme; phosphorylated in response to oxidative stress; has a role in destruction of Ssn8p; proposed to function in activation of the glycerol channel Fps1p; ASK10 has a paralog, RGC1, that arose from the whole genome duplication
SPT6	Nucleosome remodeling protein; functions in various aspects of transcription, chromatin maintenance, and RNA processing; required for the maintenance of chromatin structure during transcription in order to inhibit transcription from promoters within the coding region
	Putative protein of unknown function; deletion mutant has decreased rapamycin resistance but normal wormannin resistance; green fluorescent protein (GFP)-fusion protein localizes to the vacuole
CAF130	Part of the evolutionarily-conserved CCR4-NOT transcriptional regulatory complex involved in controlling mRNA initiation, elongation, and degradation
PSD2	Phosphatidylserine decarboxylase of the Golgi and vacuolar membranes, converts phosphatidylserine to phosphatidylethanolamine
CCH1	Voltage-gated high-affinity calcium channel involved in calcium influx in response to some environmental stresses as well as exposure to mating pheromones; interacts and co-localizes with Mid1p, suggesting Cch1p and Mid1p function together
CRM1	Major karyopherin, involved in export of proteins, RNAs, and ribosomal subunits from the nucleus; exportin
YTA7	Protein that localizes to chromatin; has a role in regulation of histone gene expression; has a bromodomain-like region that interacts with the N-terminal tail of histone H3, and an ATPase domain; relocalizes to the cytosol in response to hypoxia; potentially phosphorylated by Cdc28p
SLH1	Putative RNA helicase related to Ski2p, involved in translation inhibition of non-poly(A) mRNAs; required for repressing propagation of dsRNA viruses
YOR1	Plasma membrane ATP-binding cassette (ABC) transporter, multidrug transporter mediates export of many different organic anions including oligomycin; similar to human cystic fibrosis transmembrane receptor (CFTR)
YRF1-3	Helicase encoded by the Y' element of subtelomeric regions, highly expressed in the mutants lacking the telomerase component TLC1; potentially phosphorylated by Cdc28p
ECM29	Scaffold protein; assists in association of the proteasome core particle with the regulatory particle; degraded by the mature proteasome after assembly; contains HEAT-like repeats; protein increases in abundance and relocalizes from nucleus to cytoplasm upon DNA replication stress
MYO1	Type II myosin heavy chain, required for wild-type cytokinesis and cell separation; localizes to the actomyosin ring; binds to myosin light chains Mlc1p and Mlc2p through its IQ1 and IQ2 motifs respectively
TRA1	Subunit of SAGA and NuA4 histone acetyltransferase complexes; interacts with acidic activators (e.g., Gal4p) which leads to transcription activation; similar to human TRRAP, which is a cofactor for c-Myc mediated oncogenic transformation
KIC1	Protein kinase of the PAK/Ste20 family, required for cell integrity; physically interacts with Cdc31p (centrin), which is a component of the spindle pole body; part of the RAM network that regulates cellular polarity and morphogenesis
SET1	Histone methyltransferase, subunit of the COMPASS (Set1C) complex; COMPASS methylates histone H3K4; Set1p-dependent H3K4 trimethylation recruits Nrd1p, allowing efficient termination of snoRNAs and cryptic unstable transcripts (CUTs) by Nrd1p-Nab3p-Sen1p pathway; modulates histone acetylation levels in promoter proximal regions to ensure efficient Nrd1p-dependent termination; required in transcriptional silencing near telomeres and at silent mating type loci; has a SET domain
RTT107	Protein implicated in Mms22-dependent DNA repair during S phase; involved in recruiting the SMC5/6 complex to double-strand breaks; DNA damage induces phosphorylation by Mec1p at one or more SQ/TQ motifs; interacts with Mms22p and Slx4p; has four BRCT domains; has a role in regulation of Ty1 transposition; relative distribution to nuclear foci increases upon DNA replication stress
YSP1	Mitochondrial protein; potential role in promoting mitochondrial fragmentation during programmed cell death in response to high levels of alpha-factor mating pheromone or the drug amiodarone; YSP1 has a paralog, SIP3, that arose from the whole genome duplication
FLO5	Lectin-like cell wall protein (flocculin) involved in flocculation; binds mannose chains on the surface of other cells, confers floc-forming ability that is chymotrypsin resistant but heat labile; FLO5 has a paralog, FLO1, that arose from a segmental duplication
VTH1	Putative membrane glycoprotein with strong similarity to Vth2p and Pep1p/Vps10p, may be involved in vacuolar protein sorting
BNR1	Formin, nucleates the formation of linear actin filaments, involved in cell processes such as budding and mitotic spindle orientation which require the formation of polarized actin cables, functionally redundant with BNI1
UBP7	Ubiquitin-specific protease that cleaves ubiquitin-protein fusions; UBP7 has a paralog, UBP11, that arose from the whole genome duplication
MET18	Component of cytosolic iron-sulfur protein assembly (CIA) machinery; acts at a late step of Fe-S cluster assembly; forms the CIA targeting complex with Cia1p and Cia2p that directs Fe-S cluster incorporation into a subset of proteins involved in methionine biosynthesis, DNA replication and repair, transcription, and telomere maintenance; ortholog of human MMS19
STH1	ATPase component of the RSC chromatin remodeling complex; required for expression of early meiotic genes; essential helicase-related protein homologous to Snf2p
KGD1	Component of the mitochondrial alpha-ketoglutarate dehydrogenase complex, which catalyzes a key step in the tricarboxylic acid (TCA) cycle, the oxidative decarboxylation of alpha-ketoglutarate to form succinyl-CoA
HOS4	Subunit of the Set3 complex, which is a meiotic-specific repressor of sporulation specific genes that contains deacetylase activity; potential Cdc28p substrate
NEO1	Putative aminophospholipid translocase (flippase) involved in endocytosis and vacuolar biogenesis; localizes to endosomes and the Golgi aparatus
ULP2	Peptidase that deconjugates Smt3/SUMO-1 peptides from proteins, plays a role in chromosome cohesion at centromeric regions and recovery from checkpoint arrest induced by DNA damage or DNA replication defects; potential Cdc28p substrate
MGA2	ER membrane protein involved in regulation of OLE1 transcription; inactive ER form dimerizes and one subunit is then activated by ubiquitin/proteasome-dependent processing followed by nuclear targeting; MGA2 has a paralog, SPT23, that arose from the whole genome duplication
